############
#         \#
#          #
#   #####  #
#       #  #
#       #  #
#       #  #
#       #  #
#       #  #
#       #  #
#R         #
############
